type octile
height 10
width 20
map
..........@@........
..........@@........
..........@@........
..........@@........
....................
....................
..........@@........
..........@@........
..........@@........
..........@@........
