type octile
height 13
width 13
map
@@@@@.......@
@@@@@.......@
@@@@@..@@@@@.
@@@@@..@@@@@.
@@@@@..@@@@@.
.............
.............
.@@@@@..@@@@@
.@@@@@..@@@@@
.@@@@@..@@@@@
@.......@@@@@
@.......@@@@@
@.......@@@@@
